7 8 8 8 9
4 5 5 t 6
4 5 5 e 6
4 5 e 5 6
4 5 5 e 6
4 5 5 5 6
4 5 5 e 6
4 5 5 5 6
4 5 5 5 6
1 2 2 2 3